      R 1480 720

  NO ./srcs/texture/redbrick.xpm

SO ./srcs/texture/redbrick.xpm
  
   WE   ./srcs/texture/mossy.xpm
EA ./srcs/texture/eagle.xpm
S      ./srcs/texture/barrel.xpm




  F 42,   122  ,22  

  C   52  , 193,219   

        1111111111111111111111111
        1000000000110002222222201
        1011000001110000000000001
        1001000000000000000000001
111111111011000001110000000000001
100000000011000001110111110111111
11110111111111011100000010001
11110111111111011101010010001
11000000110101011100000010001
10002000000000001100000010001
10000000000000001101010010001
11000001110101011111011110N01
11110111 1110101 101111010001
11111111 1111111 111111111111